
=== BATCH 1 (50 entries) ===
1. toronto-international-film-festival-tiff - Toronto International Film Festival (TIFF) (Canada)
2. onex-corporation - Onex Corporation (Canada)
3. shopify - Shopify (Canada)
4. bombardier-inc - Bombardier Inc. (Canada)
5. reichmann-family-olympia-york - Reichmann Family / Olympia & York (Canada)
6. b-nai-brith-canada - B'nai Brith Canada (Canada)
7. barrick-gold-peter-munk - Barrick Gold (Peter Munk) (Canada)
8. jewish-federations-of-canada-uia - Jewish Federations of Canada - UIA (Canada)
9. mount-sinai-hospital-toronto - Mount Sinai Hospital Toronto (Canada)
10. federation-cja-montreal - Federation CJA (Montreal) (Canada)
11. centre-for-israel-and-jewish-affairs-cija - Centre for Israel and Jewish Affairs (CIJA) (Canada)
12. canadian-museum-for-human-rights - Canadian Museum for Human Rights (Canada)
13. friends-of-simon-wiesenthal-center-canada - Friends of Simon Wiesenthal Center (Canada) (Canada)
14. munk-school-of-global-affairs-u-of-toronto - Munk School of Global Affairs (U of Toronto) (Canada)
15. canadian-jewish-congress-historical - Canadian Jewish Congress (historical) (Canada)
16. canaccord-genuity - Canaccord Genuity (Canada)
17. uja-federation-of-greater-toronto - UJA Federation of Greater Toronto (Canada)
18. montreal-holocaust-museum - Montreal Holocaust Museum (Canada)
19. canadian-jewish-news - Canadian Jewish News (Canada)
20. vancouver-holocaust-education-centre - Vancouver Holocaust Education Centre (Canada)
21. toronto-hebrew-memorial-park - Toronto Hebrew Memorial Park (Canada)
22. brookfield-asset-management - Brookfield Asset Management (Canada)
23. cirque-du-soleil - Cirque du Soleil (Canada)
24. saputo-inc - Saputo Inc. (Canada)
25. canadian-friends-of-hebrew-university - Canadian Friends of Hebrew University (Canada)
26. central-council-of-jews-in-germany - Central Council of Jews in Germany (Germany)
27. delivery-hero - Delivery Hero (Germany)
28. leo-baeck-institute - Leo Baeck Institute (Germany)
29. ronald-s-lauder-foundation-germany - Ronald S. Lauder Foundation Germany (Germany)
30. jewish-museum-frankfurt - Jewish Museum Frankfurt (Germany)
31. j-disches-museum-m-nchen - J├╝disches Museum M├╝nchen (Germany)
32. maccabi-germany - Maccabi Germany (Germany)
33. wizo-germany - WIZO Germany (Germany)
34. zentralrat-der-juden-in-deutschland-central-council-of-jews-in-germany - Zentralrat der Juden in Deutschland (Central Council of Jews in Germany) (Germany)
35. axel-springer-se - Axel Springer SE (Germany)
36. stolpersteine-stumbling-stones - Stolpersteine (Stumbling Stones) (Germany)
37. j-dische-gemeinde-zu-berlin-jewish-community-of-berlin - J├╝dische Gemeinde zu Berlin (Jewish Community of Berlin) (Germany)
38. memorial-to-the-murdered-jews-of-europe - Memorial to the Murdered Jews of Europe (Germany)
39. neue-synagoge-berlin - Neue Synagoge Berlin (Germany)
40. jewish-museum-berlin - Jewish Museum Berlin (Germany)
41. sachsenhausen-memorial - Sachsenhausen Memorial (Germany)
42. abraham-geiger-college - Abraham Geiger College (Germany)
43. zalando - Zalando (Germany)
44. leo-baeck-institute-germany - Leo Baeck Institute - Germany (Germany)
45. moses-mendelssohn-center-for-european-jewish-studies - Moses Mendelssohn Center for European-Jewish Studies (Germany)
46. zentralwohlfahrtsstelle-der-juden-in-deutschland - Zentralwohlfahrtsstelle der Juden in Deutschland (Germany)
47. allgemeine-rabbinerkonferenz-general-rabbinical-conference - Allgemeine Rabbinerkonferenz (General Rabbinical Conference) (Germany)
48. european-maccabi-games - European Maccabi Games (Germany)
49. j-dische-allgemeine - J├╝dische Allgemeine (Germany)
50. atlassian - Atlassian (Australia)

=== BATCH 2 (50 entries) ===
1. jewish-holocaust-centre-melbourne - Jewish Holocaust Centre Melbourne (Australia)
2. csl-limited - CSL Limited (Australia)
3. visy-industries-anthony-pratt - Visy Industries (Anthony Pratt) (Australia)
4. lowy-institute - Lowy Institute (Australia)
5. pratt-foundation - Pratt Foundation (Australia)
6. meriton-harry-triguboff - Meriton (Harry Triguboff) (Australia)
7. jewish-museum-of-australia - Jewish Museum of Australia (Australia)
8. sydney-jewish-museum - Sydney Jewish Museum (Australia)
9. zionist-federation-of-australia - Zionist Federation of Australia (Australia)
10. nsw-jewish-board-of-deputies - NSW Jewish Board of Deputies (Australia)
11. mount-scopus-memorial-college - Mount Scopus Memorial College (Australia)
12. moriah-college-sydney - Moriah College Sydney (Australia)
13. the-australian-jewish-news - The Australian Jewish News (Australia)
14. jewish-community-council-of-victoria-jccv - Jewish Community Council of Victoria (JCCV) (Australia)
15. lendlease-group - Lendlease Group (Australia)
16. monash-university-jewish-studies - Monash University Jewish Studies (Australia)
17. sa-jewish-report - SA Jewish Report (South Africa)
18. south-african-holocaust-and-genocide-foundation - South African Holocaust and Genocide Foundation (South Africa)
19. naspers - Naspers (South Africa)
20. south-african-jewish-board-of-deputies - South African Jewish Board of Deputies (SAJBD) (South Africa)
21. cape-town-holocaust-and-genocide-centre - Cape Town Holocaust and Genocide Centre (South Africa)
22. chief-rabbi-of-south-africa - Chief Rabbi of South Africa (South Africa)
23. liberty-group-donald-gordon - Liberty Group (Donald Gordon) (South Africa)
24. discovery-limited - Discovery Limited (South Africa)
25. king-david-schools - King David Schools (South Africa)
26. investec - Investec (South Africa)
27. cape-town-holocaust-genocide-centre - Cape Town Holocaust & Genocide Centre (South Africa)
28. south-african-friends-of-israel - South African Friends of Israel (South Africa)
29. ort-south-africa - ORT South Africa (South Africa)
30. south-african-jewish-report - South African Jewish Report (South Africa)
31. herzlia-school-cape-town - Herzlia School (Cape Town) (South Africa)
32. johannesburg-holocaust-genocide-centre - Johannesburg Holocaust & Genocide Centre (South Africa)
33. pick-n-pay - Pick n Pay (South Africa)
34. nandos - Nandos (South Africa)
35. grupo-clar-n - Grupo Clar├¡n (Argentina)
36. mercado-libre - Mercado Libre (Argentina)
37. delegaci-n-de-asociaciones-israelitas-argentinas-daia - Delegaci├│n de Asociaciones Israelitas Argentinas (DAIA) (Argentina)
38. arsa-asociaci-n-de-recaudaci-n-sionista-argentina - ARSA (Asociaci├│n de Recaudaci├│n Sionista Argentina) (Argentina)
39. amia-asociaci-n-mutual-israelita-argentina - AMIA (Asociaci├│n Mutual Israelita Argentina) (Argentina)
40. daia-delegaci-n-de-asociaciones-israelitas-argentinas - DAIA (Delegaci├│n de Asociaciones Israelitas Argentinas) (Argentina)
41. buenos-aires-jewish-museum - Buenos Aires Jewish Museum (Argentina)
42. templo-libertad-buenos-aires - Templo Libertad (Buenos Aires) (Argentina)
43. beit-el-congregation-buenos-aires - Beit El Congregation (Buenos Aires) (Argentina)
44. seminario-rab-nico-latinoamericano - Seminario Rab├¡nico Latinoamericano (Argentina)
45. museo-del-holocausto-buenos-aires - Museo del Holocausto (Buenos Aires) (Argentina)
46. ort-argentina - ORT Argentina (Argentina)
47. fundacion-memoria-del-holocausto - Fundacion Memoria del Holocausto (Argentina)
48. sociedad-hebraica-argentina - Sociedad Hebraica Argentina (Argentina)
49. buenos-aires-herald-jewish-community-media - Buenos Aires Herald / Jewish community media (Argentina)
50. grupo-werthein - Grupo Werthein (Argentina)

=== BATCH 3 (50 entries) ===
1. mercadolibre - MercadoLibre (Argentina)
2. grupo-clarin - Grupo Clarin (Argentina)
3. asociaci-n-mutual-israelita-argentina-amia - Asociaci├│n Mutual Israelita Argentina (AMIA) (Argentina)
4. yandex - Yandex (Israeli R&D) (Russia)
5. letterone-mikhail-fridman - LetterOne (Mikhail Fridman) (Russia)
6. jewish-museum-and-tolerance-center - Jewish Museum and Tolerance Center (Moscow) (Russia)
7. russian-jewish-congress-rjc - Russian Jewish Congress (RJC) (Russia)
8. chief-rabbinate-of-russia - Chief Rabbinate of Russia (Russia)
9. russian-aluminum-rusal - Russian Aluminum (RUSAL) (Russia)
10. renova-group-viktor-vekselberg - Renova Group (Viktor Vekselberg) (Russia)
11. alfa-bank-alfa-group - Alfa-Bank / Alfa Group (Russia)
12. gorbi-jewish-heritage-research-group - GORBI Jewish Heritage Research Group (Russia)
13. moscow-choral-synagogue - Moscow Choral Synagogue (Russia)
14. grand-choral-synagogue-st-petersburg - Grand Choral Synagogue (St. Petersburg) (Russia)
15. synagogue-on-bolshaya-bronnaya-moscow - Synagogue on Bolshaya Bronnaya (Moscow) (Russia)
16. nornickel-vladimir-potanin - NORNICKEL (Vladimir Potanin) (Russia)
17. rusal-oleg-deripaska - Rusal (Oleg Deripaska) (Russia)
18. albert-einstein-hospital - Albert Einstein Hospital (Hospital Israelita Albert Einstein) (Brazil)
19. federation-of-jewish-communities-of-brazil-conib - Federation of Jewish Communities of Brazil (CONIB) (Brazil)
20. instituto-brasil-israel-ibi - Instituto Brasil-Israel (IBI) (Brazil)
21. hebraica-s-o-paulo - Hebraica S├úo Paulo (Brazil)
22. safra-group - Safra Group (Brazil)
23. confedera-o-israelita-do-brasil-conib - Confedera├º├úo Israelita do Brasil (CONIB) (Brazil)
24. museu-judaico-do-rio-de-janeiro - Museu Judaico do Rio de Janeiro (Brazil)
25. museu-judaico-de-s-o-paulo - Museu Judaico de S├úo Paulo (Brazil)
26. congrega-o-israelita-paulista - Congrega├º├úo Israelita Paulista (CIP) (Brazil)
27. club-hebraica-s-o-paulo - Club Hebraica S├úo Paulo (Brazil)
28. federa-o-israelita-do-estado-de-s-o-paulo-fisesp - Federa├º├úo Israelita do Estado de S├úo Paulo (FISESP) (Brazil)
29. albert-einstein-israelite-hospital - Albert Einstein Israelite Hospital (Brazil)
30. congregacao-israelita-paulista - Congregacao Israelita Paulista (Brazil)
31. 3g-capital - 3G Capital (Brazil)
32. safra-national-bank-of-new-york - Safra National Bank of New York (Brazil)
33. confederacao-israelita-do-brasil - Confederacao Israelita do Brasil (CONIB) (Brazil)
34. rede-globo - Rede Globo (Brazil)
35. magen-david-synagogue-mumbai - Magen David Synagogue, Mumbai (India)
36. bene-israel-community - Bene Israel Community (India)
37. sassoon-family-legacy - Sassoon family legacy (India)
38. chabad-house-mumbai - Chabad House Mumbai (India)
39. paradesi-synagogue-kochi - Paradesi Synagogue (Kochi) (India)
40. bene-israel-heritage-museum-mumbai - Bene Israel Heritage Museum (Mumbai) (India)
41. knesset-eliyahoo-synagogue-mumbai - Knesset Eliyahoo Synagogue (Mumbai) (India)
42. central-jewish-board-of-india - Central Jewish Board of India (India)
43. the-jewish-club-mumbai - The Jewish Club (Mumbai) (India)
44. federation-of-jewish-communities-of-india - Federation of Jewish Communities of India (India)
45. sassoon-docks - Sassoon Docks (India)
46. chabad-mumbai-nariman-house - Chabad Mumbai (Nariman House) (India)
47. reliance-industries - Reliance Industries (India)
48. cochin-jewish-heritage-centre - Cochin Jewish Heritage Centre (India)
49. benetton-group - Benetton Group (Italy)
50. unione-delle-comunit-ebraiche-italiane-ucei - Unione delle Comunit├á Ebraiche Italiane (UCEI) (Italy)

=== BATCH 4 (50 entries) ===
1. museo-ebraico-di-venezia - Museo Ebraico di Venezia (Italy)
2. comunit-ebraica-di-milano - Comunit├á Ebraica di Milano (Italy)
3. cdec-centro-di-documentazione-ebraica-contemporanea - CDEC (Centro di Documentazione Ebraica Contemporanea) (Italy)
4. venice-ghetto - Venice Ghetto (Italy)
5. great-synagogue-of-rome - Great Synagogue of Rome (Italy)
6. union-of-italian-jewish-communities-ucei - Union of Italian Jewish Communities (UCEI) (Italy)
7. community-of-sant-egidio-jewish-dialogue - Community of Sant'Egidio - Jewish dialogue (Italy)
8. synagogue-of-florence-tempio-maggiore - Synagogue of Florence (Tempio Maggiore) (Italy)
9. jewish-museum-of-bologna - Jewish Museum of Bologna (Italy)
10. jewish-museum-of-rome - Jewish Museum of Rome (Italy)
11. jewish-community-of-rome - Jewish Community of Rome (Italy)
12. jewish-ghetto-of-venice - Jewish Ghetto of Venice (Italy)
13. galicia-jewish-museum - Galicia Jewish Museum (Krakow) (Poland)
14. jewish-community-centre-of-krak-w-jcc-krak-w - Jewish Community Centre of Krak├│w (JCC Krak├│w) (Poland)
15. auschwitz-birkenau-memorial-and-museum - Auschwitz-Birkenau Memorial and Museum (Poland)
16. warsaw-ghetto-memorial - Warsaw Ghetto Memorial (Poland)
17. polin-museum-of-the-history-of-polish-jews - POLIN Museum of the History of Polish Jews (Poland)
18. treblinka-memorial - Treblinka Memorial (Poland)
19. majdanek-state-museum - Majdanek State Museum (Poland)
20. jewish-community-centre-of-krakow-jcc-krak-w - Jewish Community Centre of Krakow (JCC Krak├│w) (Poland)
21. tykocin-synagogue - Tykocin Synagogue (Poland)
22. museum-of-the-history-of-polish-jews-polin-additional-programs - Museum of the History of Polish Jews (POLIN) - additional programs (Poland)
23. foundation-preservation-jewish-heritage-poland - Foundation for the Preservation of Jewish Heritage in Poland (Poland)
24. jewish-historical-institute-warsaw - Jewish Historical Institute Warsaw (Poland)
25. credit-suisse-now-ubs - Credit Suisse (now UBS) (Switzerland)
26. nestl - Nestl├⌐ (Switzerland)
27. world-health-organization-israeli-connections - World Health Organization - Israeli connections (Switzerland)
28. schweizerischer-israelitischer-gemeindebund-sig - Schweizerischer Israelitischer Gemeindebund (SIG) (Switzerland)
29. world-jewish-congress-headquarters - World Jewish Congress (headquarters) (Switzerland)
30. swiss-federation-of-jewish-communities-sig-fsci - Swiss Federation of Jewish Communities (SIG/FSCI) (Switzerland)
31. bergier-commission-legacy - Bergier Commission legacy (Switzerland)
32. international-committee-of-the-red-cross-jewish-relationship - International Committee of the Red Cross (Jewish relationship) (Switzerland)
33. b-nai-b-rith-international-geneva-office - B'nai B'rith International (Geneva office) (Switzerland)
34. world-economic-forum - World Economic Forum (Switzerland)
35. world-zionist-organization-wzo - World Zionist Organization (WZO) (Switzerland)
36. federaci-n-de-comunidades-jud-as-de-espa-a-fcje - Federaci├│n de Comunidades Jud├¡as de Espa├▒a (FCJE) (Spain)
37. red-de-juder-as-de-espa-a - Red de Juder├¡as de Espa├▒a (Spain)
38. sephardic-house-of-barcelona - Sephardic House of Barcelona (Spain)
39. centro-sefarad-israel - Centro Sefarad-Israel (Spain)
40. casa-sefarad - Casa Sefarad (Spain)
41. museo-sefard-de-toledo - Museo Sefard├¡ de Toledo (Spain)
42. federation-of-jewish-communities-of-spain-additional - Federation of Jewish Communities of Spain (additional) (Spain)
43. museum-of-sephardic-heritage-toledo - Museum of Sephardic Heritage (Toledo) (Spain)
44. c-rdoba-synagogue - C├│rdoba Synagogue (Spain)
45. casa-sefarad-israel-madrid - Casa Sefarad-Israel (Madrid) (Spain)
46. museo-sefardi - Museo Sefardi (Spain)
47. jdc-american-jewish-joint-distribution-committee-global - JDC (American Jewish Joint Distribution Committee) - Global (International)
48. shalom-hartman-institute - Shalom Hartman Institute (International)
49. world-mizrachi - World Mizrachi (International)
50. march-of-the-living - March of the Living (International)

=== BATCH 5 (50 entries) ===
1. ohr-somayach - Ohr Somayach (International)
2. claims-conference-conference-on-jewish-material-claims-against-germany - Claims Conference (Conference on Jewish Material Claims Against Germany) (International)
3. keren-hayesod-united-israel-appeal - Keren Hayesod - United Israel Appeal (International)
4. aleph-institute - Aleph Institute (International)
5. maccabi-world-union - Maccabi World Union (International)
6. limmud-international - Limmud International (International)
7. international-holocaust-remembrance-alliance-ihra - International Holocaust Remembrance Alliance (IHRA) (International)
8. aish-hatorah - Aish HaTorah (International)
9. international-march-of-the-living - International March of the Living (International)
10. booking-com - Booking.com (Netherlands)
11. niw-nieuw-isra-lietisch-weekblad - NIW (Nieuw Isra├½lietisch Weekblad) (Netherlands)
12. joods-historisch-museum - Joods Historisch Museum (Netherlands)
13. centraal-joods-overleg-cjo - Centraal Joods Overleg (CJO) (Netherlands)
14. nederlands-isra-litisch-kerkgenootschap-nik - Nederlands-Isra├½litisch Kerkgenootschap (NIK) (Netherlands)
15. portuguese-synagogue-of-amsterdam - Portuguese Synagogue of Amsterdam (Netherlands)
16. anne-frank-house - Anne Frank House (Netherlands)
17. jewish-historical-museum-amsterdam - Jewish Historical Museum (Amsterdam) (Netherlands)
18. westerbork-transit-camp-memorial - Westerbork Transit Camp Memorial (Netherlands)
19. nik-nederlands-isra-litisch-kerkgenootschap - NIK (Nederlands-Isra├½litisch Kerkgenootschap) (Netherlands)
20. national-holocaust-museum-amsterdam - National Holocaust Museum (Amsterdam) (Netherlands)
21. grupo-televisa - Grupo Televisa (Jewish connections) (Mexico)
22. grupo-carso - Grupo Carso (Mexico)
23. tribunal-tarbut - Tribunal Tarbut (Mexico)
24. centro-deportivo-israelita - Centro Deportivo Israelita (Mexico)
25. kadima-community - Kadima Community (Mexico)
26. museo-memoria-y-tolerancia - Museo Memoria y Tolerancia (Mexico)
27. comit-central-de-la-comunidad-jud-a-de-m-xico - Comit├⌐ Central de la Comunidad Jud├¡a de M├⌐xico (Mexico)
28. colegio-hebreo-maguen-david - Colegio Hebreo Maguen David (Mexico)
29. tribuna-israelita - Tribuna Israelita (Mexico)
30. kidzania - KidZania (Mexico)
31. comite-central-comunidad-judia-mexico - Comite Central de la Comunidad Judia de Mexico (Mexico)
32. sigmund-freud-museum - Sigmund Freud Museum (Vienna) (Austria)
33. j-disches-museum-wien - J├╝disches Museum Wien (Austria)
34. lauder-chabad-campus-wien - Lauder Chabad Campus Wien (Austria)
35. israelitische-kultusgemeinde-wien-jewish-community-of-vienna - Israelitische Kultusgemeinde Wien (Jewish Community of Vienna) (Austria)
36. mauthausen-memorial - Mauthausen Memorial (Austria)
37. jewish-museum-vienna - Jewish Museum Vienna (Austria)
38. stadttempel-vienna-city-temple - Stadttempel (Vienna City Temple) (Austria)
39. vienna-wiesenthal-institute - Vienna Wiesenthal Institute (Austria)
40. jewish-community-of-vienna - Jewish Community of Vienna (Austria)
41. mus-e-juif-de-belgique - Mus├⌐e Juif de Belgique (Belgium)
42. comit-de-coordination-des-organisations-juives-de-belgique-ccojb - Comit├⌐ de Coordination des Organisations Juives de Belgique (CCOJB) (Belgium)
43. kazerne-dossin-memorial - Kazerne Dossin Memorial (Mechelen) (Belgium)
44. antwerp-diamond-district - Antwerp Diamond District (Belgium)
45. antwerp-jewish-community - Antwerp Jewish Community (Belgium)
46. jewish-museum-of-belgium-brussels - Jewish Museum of Belgium (Brussels) (Belgium)
47. coordinating-committee-of-jewish-organisations-in-belgium-ccojb - Coordinating Committee of Jewish Organisations in Belgium (CCOJB) (Belgium)
48. antwerp-diamond-centre - Antwerp Diamond Centre (Belgium)
49. paideia-the-european-institute-for-jewish-studies - Paideia - The European Institute for Jewish Studies (Sweden)
50. judiska-f-rsamlingen-i-stockholm - Judiska F├╢rsamlingen i Stockholm (Sweden)

=== BATCH 6 (50 entries) ===
1. judiska-museet-i-stockholm - Judiska Museet i Stockholm (Sweden)
2. official-council-of-swedish-jewish-communities - Official Council of Swedish Jewish Communities (Sweden)
3. raoul-wallenberg-institute - Raoul Wallenberg Institute (Sweden)
4. great-synagogue-of-stockholm - Great Synagogue of Stockholm (Sweden)
5. jewish-museum-stockholm - Jewish Museum Stockholm (Sweden)
6. jewish-community-stockholm - Jewish Community of Stockholm (Sweden)
7. bonnier-group - Bonnier Group (Sweden)
8. doh-ny-street-synagogue-budapest - Doh├íny Street Synagogue (Budapest) (Hungary)
9. raoul-wallenberg-memorial - Raoul Wallenberg Memorial (Hungary)
10. federation-of-hungarian-jewish-communities-mazsihisz - Federation of Hungarian Jewish Communities (Mazsihisz) (Hungary)
11. hungarian-jewish-museum - Hungarian Jewish Museum (Hungary)
12. shoes-on-the-danube-bank - Shoes on the Danube Bank (Hungary)
13. hungarian-jewish-heritage-foundation - Hungarian Jewish Heritage Foundation (Hungary)
14. ort-hungary - ORT Hungary (Hungary)
15. dohany-street-synagogue - Dohany Street Synagogue (Hungary)
16. turkish-jewish-community - Turkish Jewish Community (Turkey)
17. t-rkiye-musevi-cemaati - T├╝rkiye Musevi Cemaati (Turkey)
18. museum-of-turkish-jews - Museum of Turkish Jews (Turkey)
19. neve-shalom-synagogue - Neve Shalom Synagogue (Istanbul) (Turkey)
20. ahrida-synagogue-istanbul - Ahrida Synagogue (Istanbul) (Turkey)
21. quincentennial-foundation-museum-istanbul - Quincentennial Foundation Museum (Istanbul) (Turkey)
22. chief-rabbinate-of-turkey - Chief Rabbinate of Turkey (Turkey)
23. quincentennial-foundation-turkey - Quincentennial Foundation (Turkey)
24. conseil-des-communaut-s-isra-lites-du-maroc - Conseil des Communaut├⌐s Isra├⌐lites du Maroc (Morocco)
25. museum-of-moroccan-judaism - Museum of Moroccan Judaism (Casablanca) (Morocco)
26. bayt-dakira-house-of-memory - Bayt Dakira (House of Memory, Essaouira) (Morocco)
27. council-of-jewish-communities-of-morocco - Council of Jewish Communities of Morocco (Morocco)
28. rabbi-haim-pinto-synagogue-essaouira - Rabbi Haim Pinto Synagogue (Essaouira) (Morocco)
29. casablanca-jewish-heritage-trail - Casablanca Jewish Heritage Trail (Morocco)
30. conseil-des-communautes-israelites-du-maroc - Conseil des Communautes Israelites du Maroc (Morocco)
31. kaifeng-jewish-community - Kaifeng Jewish Community (China)
32. shanghai-jewish-refugees-museum - Shanghai Jewish Refugees Museum (China)
33. sassoon-house-shanghai - Sassoon House (Shanghai) (China)
34. sassoon-group-legacy - Sassoon Group Historical Legacy (China)
35. tencent - Tencent (China)
36. babyn-yar-holocaust-memorial-center - Babyn Yar Holocaust Memorial Center (Ukraine)
37. golden-rose-synagogue-lviv-ruins - Golden Rose Synagogue (Lviv, ruins) (Ukraine)
38. menorah-center-dnipro - Menorah Center (Dnipro) (Ukraine)
39. uman-breslov-pilgrimage - Uman (Breslov pilgrimage) (Ukraine)
40. jewish-confederation-of-ukraine - Jewish Confederation of Ukraine (Ukraine)
41. united-jewish-community-of-ukraine - United Jewish Community of Ukraine (Ukraine)
42. ukrainian-jewish-confederation - Ukrainian Jewish Confederation (Ukraine)
43. jewish-quarter-of-prague-josefov - Jewish Quarter of Prague (Josefov) (Czech Republic)
44. old-new-synagogue-altneuschul - Old-New Synagogue (Altneuschul) (Czech Republic)
45. federace-idovsk-ch-obc-v-esk-republice - Federace ┼╛idovsk├╜ch obc├¡ v ─îesk├⌐ republice (Czech Republic)
46. terez-n-memorial - Terez├¡n Memorial (Czech Republic)
47. jewish-museum-in-prague - Jewish Museum in Prague (Czech Republic)
48. old-jewish-cemetery-prague - Old Jewish Cemetery (Prague) (Czech Republic)
49. federation-of-jewish-communities-in-the-czech-republic - Federation of Jewish Communities in the Czech Republic (Czech Republic)
50. pinkas-synagogue-prague-holocaust-memorial - Pinkas Synagogue (Prague Holocaust Memorial) (Czech Republic)

=== BATCH 7 (50 entries) ===
1. toyota-motor-corporation - Toyota Motor Corporation (Japan)
2. jewish-community-of-kobe - Jewish Community of Kobe (Japan)
3. makuya - Makuya (Japan)
4. sugihara-museum-yaotsu - Sugihara Museum (Yaotsu) (Japan)
5. jewish-community-of-japan - Jewish Community of Japan (Japan)
6. kobe-jewish-community - Kobe Jewish Community (Japan)
7. softbank-group - SoftBank Group (Japan)
8. novo-nordisk - Novo Nordisk (Denmark)
9. danish-jewish-museum - Danish Jewish Museum (Copenhagen) (Denmark)
10. rescue-of-danish-jews-1943 - Rescue of Danish Jews (1943) (Denmark)
11. jewish-community-of-denmark - Jewish Community of Denmark (Denmark)
12. great-synagogue-of-copenhagen - Great Synagogue of Copenhagen (Denmark)
13. det-mosaiske-troessamfund - Det Mosaiske Troessamfund (Denmark)
14. central-board-of-jewish-communities-in-greece-kis - Central Board of Jewish Communities in Greece (KIS) (Greece)
15. romaniote-jewish-community - Romaniote Jewish Community (Greece)
16. jewish-museum-of-thessaloniki - Jewish Museum of Thessaloniki (Greece)
17. jewish-museum-of-greece - Jewish Museum of Greece (Greece)
18. holocaust-memorial-of-thessaloniki - Holocaust Memorial of Thessaloniki (Greece)
19. beta-israel-community-organizations - Beta Israel Community Organizations (Ethiopia)
20. operation-solomon-memorial - Operation Solomon Memorial (Ethiopia)
21. north-shewa-synagogue - North Shewa Synagogue (Ethiopia)
22. north-american-conference-on-ethiopian-jewry - North American Conference on Ethiopian Jewry (Ethiopia)
23. ethiopian-jewish-community-beta-israel - Ethiopian Jewish Community (Beta Israel) (Ethiopia)
24. north-shewa-zone-heritage-center - North Shewa Zone Heritage Center (Ethiopia)
25. jewish-museum-oslo - Jewish Museum Oslo (Norway)
26. jewish-community-of-oslo - Jewish Community of Oslo (Norway)
27. det-mosaiske-trossamfund-i-oslo - Det Mosaiske Trossamfund i Oslo (Norway)
28. center-for-studies-of-the-holocaust-and-religious-minorities-hl-senteret - Center for Studies of the Holocaust and Religious Minorities (HL-senteret) (Norway)
29. jewish-museum-trondheim - Jewish Museum Trondheim (Norway)
30. jewish-museum-of-oslo - Jewish Museum of Oslo (Norway)
31. federa-ia-comunit-ilor-evreie-ti-din-rom-nia-fcer - Federa╚¢ia Comunit─â╚¢ilor Evreie╚Öti din Rom├ónia (FCER) (Romania)
32. coral-temple - Coral Temple (Romania)
33. federation-of-jewish-communities-in-romania - Federation of Jewish Communities in Romania (Romania)
34. abrahamic-family-house - Abrahamic Family House (Abu Dhabi) (United Arab Emirates)
35. jewish-community-of-the-uae - Jewish Community of the UAE (United Arab Emirates)
36. association-of-gulf-jewish-communities-agjc - Association of Gulf Jewish Communities (AGJC) (United Arab Emirates)
37. kosher-restaurants-and-community-in-dubai - Kosher restaurants and community in Dubai (United Arab Emirates)
38. jewish-council-of-the-emirates - Jewish Council of the Emirates (United Arab Emirates)
39. seoul-jewish-community - Seoul Jewish Community (South Korea)
40. chabad-of-south-korea - Chabad of South Korea (South Korea)
41. samsung-group - Samsung Group (South Korea)
42. jewish-welfare-board-singapore - Jewish Welfare Board Singapore (Singapore)
43. maghain-aboth-synagogue - Maghain Aboth Synagogue (Singapore)
44. united-hebrew-congregation-of-singapore - United Hebrew Congregation of Singapore (Singapore)
45. singapore-jewish-community - Singapore Jewish Community (Singapore)
46. singapore-jewish-welfare-board - Singapore Jewish Welfare Board (Singapore)
47. sinagoga-de-tomar - Sinagoga de Tomar (Portugal)
48. museu-judaico-de-belmonte - Museu Judaico de Belmonte (Portugal)
49. jewish-community-of-lisbon - Jewish Community of Lisbon (Portugal)
50. sinagoga-kadoorie-mekor-haim-porto - Sinagoga Kadoorie Mekor Haim (Porto) (Portugal)

=== BATCH 8 (50 entries) ===
1. comunidade-israelita-de-lisboa - Comunidade Israelita de Lisboa (Portugal)
2. the-synagogue-of-bahrain - The Synagogue of Bahrain (Bahrain)
3. ambassador-houda-nonoo-legacy - Ambassador Houda Nonoo legacy (Bahrain)
4. jewish-community-of-bahrain - Jewish Community of Bahrain (Bahrain)
5. house-of-ten-commandments - House of Ten Commandments (Bahrain)
6. instituto-hebreo-dr-chaim-weizmann - Instituto Hebreo Dr. Chaim Weizmann (Chile)
7. comunidad-jud-a-de-chile - Comunidad Jud├¡a de Chile (Chile)
8. comunidad-judia-de-chile - Comunidad Judia de Chile (Chile)
9. colegio-colombo-hebreo - Colegio Colombo Hebreo (Colombia)
10. confederacion-comunidades-judias-colombia - Confederacion de Comunidades Judias de Colombia (Colombia)
11. central-council-of-jewish-communities-in-finland - Central Council of Jewish Communities in Finland (Finland)
12. jewish-community-helsinki - Jewish Community of Helsinki (Finland)
13. helsingin-juutalainen-seurakunta - Helsingin Juutalainen Seurakunta (Finland)
14. helsinki-synagogue - Helsinki Synagogue (Finland)
15. jewish-community-centre-hong-kong - Jewish Community Centre Hong Kong (Hong Kong)
16. jewish-historical-society-of-hong-kong - Jewish Historical Society of Hong Kong (Hong Kong)
17. kadoorie-family-enterprises - Kadoorie Family Enterprises (Hong Kong)
18. jewish-representative-council-of-ireland - Jewish Representative Council of Ireland (Ireland)
19. irish-jewish-museum-dublin - Irish Jewish Museum (Dublin) (Ireland)
20. colegio-le-n-pinelo - Colegio Le├│n Pinelo (Peru)
21. asociacion-judia-del-peru - Asociacion Judia del Peru (Peru)
22. eliyahu-hanavi-synagogue - Eliyahu Hanavi Synagogue (Egypt)
23. egyptian-jewish-community-historic - Egyptian Jewish Community (historic) (Egypt)
24. ben-ezra-synagogue-cairo - Ben Ezra Synagogue (Cairo) (Egypt)
25. sha-ar-hashamayim-synagogue - Sha'ar Hashamayim Synagogue (Egypt)
26. jewish-community-of-thailand - Jewish Community of Thailand (Thailand)
27. jewish-association-of-thailand - Jewish Association of Thailand (Thailand)
28. temple-emil-manila - Temple Emil, Manila (Philippines)
29. comunidad-israelita-del-uruguay - Comunidad Israelita del Uruguay (Uruguay)
30. comit-central-israelita-del-uruguay - Comit├⌐ Central Israelita del Uruguay (Uruguay)
31. comite-central-israelita-del-uruguay - Comite Central Israelita del Uruguay (Uruguay)
32. auckland-hebrew-congregation - Auckland Hebrew Congregation (New Zealand)
33. wellington-hebrew-congregation - Wellington Hebrew Congregation (New Zealand)
34. new-zealand-jewish-council - New Zealand Jewish Council (New Zealand)
35. jewish-community-of-belgrade - Jewish Community of Belgrade (Serbia)
36. federation-of-jewish-communities-in-serbia - Federation of Jewish Communities in Serbia (Serbia)
37. jewish-community-belgrade - Federation of Jewish Communities of Serbia (Serbia)
38. jewish-community-of-bulgaria - Jewish Community of Bulgaria (Bulgaria)
39. organization-of-the-jews-in-bulgaria - Organization of the Jews in Bulgaria (Bulgaria)
40. shalom-organization-jews-bulgaria - Shalom Organization of Jews in Bulgaria (Bulgaria)
41. asociaci-n-de-beneficencia-israelita-de-quito - Asociaci├│n de Beneficencia Israelita de Quito (Ecuador)
42. iraqi-jewish-community-historic - Iraqi Jewish Community (historic) (Iraq)
43. babylonian-jewry-heritage-center-israel - Babylonian Jewry Heritage Center (Israel) (Iraq)
44. iraqi-jewish-heritage - Iraqi Jewish Heritage (Iraq)
45. musmeah-yeshua-synagogue - Musmeah Yeshua Synagogue (Yangon) (Myanmar)
46. taiwan-jewish-community - Taiwan Jewish Community (Taiwan)
47. jewish-community-of-taiwan - Jewish Community of Taiwan (Taiwan)
48. tsmc-taiwan-semiconductor-manufacturing-company - TSMC (Taiwan Semiconductor Manufacturing Company) (Taiwan)
49. jewish-community-of-madagascar - Jewish Community of Madagascar (Madagascar)
50. community-of-jewish-descent-in-madagascar - Community of Jewish Descent in Madagascar (Madagascar)

=== BATCH 9 (50 entries) ===
1. jewish-community-madagascar - Communaut├⌐ Juive de Madagascar (Madagascar)
2. colegio-instituto-alberto-einstein - Colegio Instituto Alberto Einstein (Panama)
3. kol-shearith-israel - Kol Shearith Israel (Panama)
4. patronato-de-la-casa-de-la-comunidad-hebrea-de-cuba - Patronato de la Casa de la Comunidad Hebrea de Cuba (Cuba)
5. jewish-community-cuba - Comunidad Hebrea de Cuba (Cuba)
6. confederaci-n-de-asociaciones-israelitas-de-venezuela-caiv - Confederaci├│n de Asociaciones Israelitas de Venezuela (CAIV) (Venezuela)
7. confederacion-asociaciones-israelitas-venezuela - CAIV - Confederaci├│n de Asociaciones Israelitas de Venezuela (Venezuela)
8. caiv-venezuela - Confederacion de Asociaciones Israelitas de Venezuela (Venezuela)
9. united-congregation-of-israelites - United Congregation of Israelites (Jamaica)
10. shaare-shalom-synagogue - Shaare Shalom Synagogue (Jamaica)
11. mountain-jewish-community-of-azerbaijan - Mountain Jewish Community of Azerbaijan (Azerbaijan)
12. mountain-jews-azerbaijan - Mountain Jews of Azerbaijan (Azerbaijan)
13. nairobi-hebrew-congregation - Nairobi Hebrew Congregation (Kenya)
14. abayudaya-jewish-community - Abayudaya Jewish Community of Uganda (East Africa Office) (Kenya)
15. jewish-community-of-zagreb - Jewish Community of Zagreb (Croatia)
16. el-ghriba-synagogue-djerba - El Ghriba Synagogue (Djerba) (Tunisia)
17. jewish-community-of-sos-a - Jewish Community of Sos├║a (Dominican Republic)
18. museo-jud-o-de-sos-a - Museo Jud├¡o de Sos├║a (Dominican Republic)
19. chabad-vietnam - Chabad Vietnam (Vietnam)
20. jewish-community-vietnam - Jewish Community of Ho Chi Minh City (Vietnam)
21. igbo-jewish-community - Igbo Jewish Community (Nigeria)
22. jewish-community-of-nigeria - Jewish Community of Nigeria (Igbo Jews) (Nigeria)
23. sephardi-hebrew-congregation-of-harare - Sephardi Hebrew Congregation of Harare (Zimbabwe)
24. zimbabwe-jewish-community - Zimbabwe Jewish Community (Zimbabwe)
25. communaut-juive-de-lubumbashi - Communaut├⌐ Juive de Lubumbashi (Democratic Republic of Congo)
26. lubumbashi-jewish-community - Lubumbashi Jewish Community (Democratic Republic of Congo)
27. windhoek-hebrew-congregation - Windhoek Hebrew Congregation (Namibia)
28. windhoek-jewish-community - Windhoek Jewish Community (Namibia)
29. house-of-israel-community - House of Israel Community (Ghana)
30. house-of-israel-ghana - House of Israel Ghana (Ghana)
31. yemeni-jewish-community-historic - Yemeni Jewish Community (historic) (Yemen)
32. yemenite-jewish-heritage - Yemenite Jewish Heritage (Yemen)
33. libyan-jewish-community-historic - Libyan Jewish Community (historic) (Libya)
34. libyan-jewish-heritage - Libyan Jewish Heritage (Libya)
35. lebanese-jewish-community-historic - Lebanese Jewish Community (historic) (Lebanon)
36. maghen-abraham-synagogue - Maghen Abraham Synagogue (Lebanon)
37. jodensavanne-archaeological-site - Jodensavanne Archaeological Site (Suriname)
38. neve-shalom-synagogue-paramaribo - Neve Shalom Synagogue (Paramaribo) (Suriname)
39. gibraltar-hebrew-community - Gibraltar Hebrew Community (Gibraltar)
40. jewish-community-of-gibraltar - Jewish Community of Gibraltar (Gibraltar)
41. lusaka-hebrew-congregation - Lusaka Hebrew Congregation (Zambia)
42. council-for-zambian-jewry - Council for Zambian Jewry (Zambia)
43. vilna-gaon-jewish-state-museum - Vilna Gaon Jewish State Museum (Lithuania)
44. lithuanian-jewish-community-ljc - Lithuanian Jewish Community (LJC) (Lithuania)
45. jews-in-latvia-museum - Jews in Latvia Museum (Latvia)
46. riga-ghetto-holocaust-museum - Riga Ghetto and Latvian Holocaust Museum (Latvia)
47. jewish-community-of-estonia - Jewish Community of Estonia (Estonia)
48. tehran-jewish-committee - Tehran Jewish Committee (Iran)
49. georgian-jewish-community - Georgian Jewish Community (Georgia)
50. bukharan-jewish-community - Bukharan Jewish Community (Uzbekistan)

=== BATCH 10 (31 entries) ===
1. comunidad-israelita-de-bolivia-circulo-israelita - Comunidad Israelita de Bolivia (Circulo Israelita) (Bolivia)
2. syrian-jewish-heritage-aleppo-damascus - Syrian Jewish Heritage (Aleppo/Damascus) (Syria)
3. mikv-israel-emanuel-synagogue - Mikv├⌐ Israel-Emanuel Synagogue (Cura├ºao)
4. jewish-community-tanzania - Jewish Community of Dar es Salaam (Tanzania)
5. caribbean-jewish-congress - Caribbean Jewish Congress (Trinidad and Tobago)
6. jewish-community-of-botswana - Jewish Community of Botswana (Botswana)
7. union-of-belarusian-jewish-public-associations-and-communities - Union of Belarusian Jewish Public Associations and Communities (Belarus)
8. jewish-community-of-kazakhstan - Jewish Community of Kazakhstan (Kazakhstan)
9. surabaya-jewish-community - Surabaya Jewish Community (Indonesia)
10. icelandic-jewish-community - Icelandic Jewish Community (Iceland)
11. jewish-community-of-lubumbashi - Jewish Community of Lubumbashi (Democratic Republic of the Congo)
12. nidhe-israel-synagogue - Nidhe Israel Synagogue (Barbados)
13. hebrew-congregation-of-st-thomas - Hebrew Congregation of St. Thomas (U.S. Virgin Islands)
14. jewish-community-of-dushanbe - Jewish Community of Dushanbe (Tajikistan)
15. chabad-of-kathmandu - Chabad of Kathmandu (Nepal)
16. chabad-of-phnom-penh - Chabad of Phnom Penh (Cambodia)
17. chabad-of-vientiane - Chabad of Vientiane (Laos)
18. jewish-community-of-sri-lanka - Jewish Community of Sri Lanka (Sri Lanka)
19. jewish-community-of-port-moresby - Jewish Community of Port Moresby (Papua New Guinea)
20. jewish-community-of-suva - Jewish Community of Suva (Fiji)
21. jewish-heritage-of-malta - Jewish Heritage of Malta (Malta)
22. jewish-community-of-luxembourg - Jewish Community of Luxembourg (Luxembourg)
23. association-culturelle-isra-lite-de-monaco - Association Culturelle Isra├⌐lite de Monaco (Monaco)
24. jewish-community-of-andorra - Jewish Community of Andorra (Andorra)
25. jewish-community-of-cyprus - Jewish Community of Cyprus (Cyprus)
26. jewish-community-of-sarajevo - Jewish Community of Sarajevo (Bosnia and Herzegovina)
27. jewish-community-of-skopje - Jewish Community of Skopje (North Macedonia)
28. jewish-community-of-albania - Jewish Community of Albania (Albania)
29. jewish-community-of-ljubljana - Jewish Community of Ljubljana (Slovenia)
30. jewish-community-of-bratislava - Jewish Community of Bratislava (Slovakia)
31. jewish-community-of-montenegro - Jewish Community of Montenegro (Montenegro)

Total sparse: 481 | Batches: 10
